#    #   # #    #
  #    #   # #  #
    #      #   ##
  #    #        #
  #    #    #  ##
#    #      #   #