###  ##     #    #
  #  #   #  # #  #
  #  #   #  # #  #
        #  #  #  #
#########     #  #
        #######  #
